25 15
#########################
#....#.............#...o#
#.##.#.### ### ###.#.##.#
t......#.........#......t
#.##.#.### ### ###.#.##.#
#.#......#..o..#......#.#
#.#.##.#.###-###.#.##.#.#
t...p..#.#cm yr#.#..p...t
#.#.##.#.#######.#.##.#.#
#.#......#.....#......#.#
#.##.#.### ### ###.#.##.#
t......#.........#......t
#.##.#.### ### ###.#.##.#
#o...#.............#....#
#########################