25 11
#########################
#...........o...........#
#.###.###.#.#.#.###.###.#
#.#.o.....#...#.......#.#
#.#.#.##.###-###.##.#.#.#
t ..p..#.#cm yr#.#..p.. t
#.#.#.##.#######.##.#.#.#
#.#.......#...#.....o.#.#
#.###.###.#.#.#.###.###.#
#.......................#
#########################