25 11
#########################
#....#.............#...o#
#.##.#.### ### ###.#.##.#
#.#......#..o..#......#.#
#.#.##.#.###-###.#.##.#.#
t......#.#cm yr#.#......t
#.#.##.#.#######.#.##.#.#
#.#......#..p..#......#.#
#.##.#.### ### ###.#.##.#
#o...#.............#....#
#########################